31
20
0,0,0,0,0,0,0,0,0,0,0,0,0,0,0,0,0,0,0,0,0,0,0,0,0,0,0,0,0,0,0,
0,7,7,7,7,7,7,7,10,7,7,7,10,7,7,7,7,7,10,7,7,7,10,7,7,7,7,7,7,7,0,
0,7,7,7,7,7,7,7,7,7,7,7,7,7,7,7,7,7,7,7,7,7,7,7,7,7,7,7,7,7,0,
0,7,7,7,7,7,7,7,7,7,7,7,7,7,7,7,7,7,7,7,7,7,7,7,7,7,7,7,7,7,0,
0,7,7,7,7,7,7,7,7,7,7,7,7,7,7,9,7,7,7,7,7,7,7,7,7,7,7,7,7,7,0,
0,0,0,0,0,0,0,0,7,7,0,0,0,0,7,7,7,0,0,0,0,7,7,0,0,0,0,0,0,0,0,
0,7,7,7,7,7,7,7,7,7,7,7,0,0,7,7,7,0,0,7,7,7,7,7,7,7,7,7,7,7,0,
0,7,7,7,7,7,7,7,7,7,0,0,0,7,7,0,7,7,0,0,0,7,7,7,7,7,7,7,7,7,0,
0,7,7,0,7,7,7,7,7,0,0,7,7,7,7,0,7,7,7,7,0,0,7,7,7,7,7,0,7,7,0,
0,7,7,7,7,7,7,0,0,0,7,7,0,0,7,7,7,0,0,7,7,0,0,0,7,7,7,7,7,7,0,
0,7,7,7,7,0,0,0,7,7,7,7,7,7,7,7,7,7,7,7,7,7,7,0,0,0,7,7,7,7,0,
0,7,7,0,0,0,7,7,7,0,0,7,7,0,0,7,0,0,7,7,0,0,7,7,7,0,0,0,7,7,0,
0,0,0,0,7,7,7,7,7,7,7,7,7,7,7,7,7,7,7,7,7,7,7,7,7,7,7,0,0,0,0,
0,0,0,0,0,0,0,7,7,7,7,0,7,7,7,0,7,7,7,0,7,7,7,7,0,0,0,0,0,0,0,
0,0,7,7,7,7,7,0,0,7,0,0,7,0,0,0,0,0,7,0,0,7,0,0,7,7,7,7,7,7,0,
0,7,7,7,7,7,7,7,7,7,7,7,7,7,7,7,7,7,7,7,7,7,7,7,7,7,7,7,7,7,0,
0,11,7,7,7,7,18,18,18,7,7,18,18,18,7,7,7,18,18,18,7,7,18,18,18,7,7,7,7,11,0,
0,11,11,7,7,7,18,18,18,7,7,18,18,18,7,7,7,18,18,18,7,7,18,18,18,7,7,7,11,11,0,
0,11,11,11,7,7,18,57,18,7,7,18,57,18,7,7,7,18,57,18,7,7,18,57,18,7,7,11,11,11,0,
0,0,0,0,0,0,0,0,0,0,0,0,0,0,0,0,0,0,0,0,0,0,0,0,0,0,0,0,0,0,0,