76
12
13,13,13,13,13,13,13,13,13,13,13,13,13,13,13,13,13,13,13,13,13,13,13,13,13,13,13,13,13,13,13,13,13,13,13,13,13,13,13,13,13,13,13,13,13,13,13,13,13,13,13,13,13,13,13,13,13,13,13,13,13,13,13,13,13,13,13,13,13,13,13,13,13,13,13,13,
13,7,7,7,18,18,7,18,18,18,7,7,18,18,18,7,18,18,7,18,58,18,18,7,7,18,18,58,58,18,7,7,7,18,18,58,7,7,18,58,58,58,7,18,18,58,18,7,18,18,18,18,18,7,18,18,18,7,7,7,18,58,18,7,7,18,18,58,18,18,18,18,7,7,7,13,
13,7,7,7,18,58,7,18,18,58,7,7,18,58,18,7,18,58,7,18,58,58,58,7,7,18,58,18,58,18,7,7,7,18,58,18,7,7,18,18,18,18,7,18,58,58,18,7,18,18,58,58,18,7,18,58,18,7,7,7,18,18,18,7,7,18,18,58,18,18,58,18,7,7,7,13,
13,7,7,0,0,0,0,0,0,0,0,0,0,0,0,0,0,0,0,0,0,0,0,0,0,0,0,0,0,0,0,0,0,0,0,0,0,0,0,0,0,0,0,0,0,0,0,0,0,0,0,0,0,0,0,0,0,0,0,0,0,0,0,0,0,0,0,0,0,0,0,0,0,7,7,13,
13,18,18,0,11,11,11,11,11,7,18,18,18,18,18,18,18,7,18,18,58,18,7,18,18,18,18,18,18,18,7,18,18,58,18,7,18,18,18,18,18,18,18,7,58,18,18,18,7,18,18,18,18,18,18,18,7,18,58,18,18,7,18,18,18,18,0,18,18,18,18,18,0,58,18,13,
13,18,58,0,11,11,11,11,11,7,18,18,18,18,18,18,18,7,58,18,18,18,7,18,18,18,18,18,18,18,7,18,18,18,18,7,18,18,18,18,18,18,18,7,18,18,18,18,7,18,18,18,18,18,18,18,7,18,18,18,18,7,18,18,18,18,0,18,18,18,18,18,0,18,58,13,
13,58,18,0,11,11,11,11,11,7,18,18,18,18,18,18,18,7,18,18,18,18,7,18,18,18,18,18,18,18,7,58,18,58,18,7,18,18,18,18,18,18,18,7,18,18,18,18,7,18,18,18,18,18,18,18,7,18,18,18,18,7,18,18,18,18,0,18,18,18,18,18,0,58,18,13,
13,18,58,0,11,11,11,11,11,7,18,18,18,18,18,18,18,11,18,58,18,58,7,18,18,18,18,18,18,18,11,18,18,18,18,7,18,18,18,18,18,18,18,11,58,18,18,18,7,18,18,18,18,18,18,18,11,18,18,18,18,7,18,18,18,18,18,18,9,18,18,18,0,18,58,13,
13,7,7,0,0,0,0,0,0,0,0,0,0,0,0,0,0,0,0,0,0,0,0,0,0,0,0,0,0,0,0,0,0,0,0,0,0,0,0,0,0,0,0,0,0,0,0,0,0,0,0,0,0,0,0,0,0,0,0,0,0,0,0,0,0,0,0,0,0,0,0,0,0,7,7,13,
13,7,7,7,18,58,7,7,18,58,7,7,58,18,58,7,7,7,18,58,7,58,18,7,18,58,7,58,18,7,7,18,58,7,18,18,7,58,18,7,18,18,7,7,7,18,58,18,7,7,18,58,58,18,7,7,7,18,18,18,58,18,18,18,7,18,18,18,7,7,18,18,7,7,7,13,
13,7,7,7,18,18,7,7,58,18,7,7,18,18,18,7,7,7,18,18,7,58,18,7,18,58,7,18,18,7,7,18,58,7,58,58,7,58,18,7,18,58,7,7,7,18,18,18,7,7,18,18,58,18,7,7,7,18,18,58,18,18,58,18,7,18,58,18,7,7,58,18,7,7,7,13,
13,13,13,13,13,13,13,13,13,13,13,13,13,13,13,13,13,13,13,13,13,13,13,13,13,13,13,13,13,13,13,13,13,13,13,13,13,13,13,13,13,13,13,13,13,13,13,13,13,13,13,13,13,13,13,13,13,13,13,13,13,13,13,13,13,13,13,13,13,13,13,13,13,13,13,13,