33
33
0,0,0,0,0,0,0,0,0,0,0,0,0,0,0,0,0,0,0,0,0,0,0,0,0,0,0,0,0,0,0,0,0,
0,7,7,7,7,7,0,18,18,18,18,18,18,18,18,18,18,18,18,18,18,18,18,18,18,18,0,7,7,7,7,7,0,
0,7,7,3,7,7,0,18,18,18,18,18,18,18,18,18,18,18,18,18,18,18,18,18,18,18,0,7,7,3,7,7,0,
0,7,7,7,7,7,0,18,18,18,18,18,18,18,18,18,18,18,18,18,18,18,18,18,18,18,0,7,7,7,7,7,0,
0,7,7,7,7,7,0,18,18,18,18,18,18,18,18,18,57,18,18,18,18,18,18,18,18,18,0,7,7,7,7,7,0,
0,7,7,7,7,7,0,18,18,18,18,18,18,18,18,18,0,18,18,18,18,18,18,18,18,18,0,7,7,7,7,7,0,
0,7,7,7,7,7,0,18,18,18,18,18,18,18,18,0,11,0,18,18,18,18,18,18,18,18,0,7,7,7,7,7,0,
0,7,7,7,7,7,0,18,18,18,18,18,18,18,0,7,10,57,0,18,18,18,18,18,18,18,0,7,7,7,7,7,0,
0,7,7,7,7,7,0,18,18,18,18,18,18,0,7,10,7,10,7,0,18,18,18,18,18,18,0,7,7,7,7,7,0,
0,7,7,7,7,7,0,18,18,18,18,18,0,57,10,7,10,7,10,7,0,18,18,18,18,18,0,7,7,7,7,7,0,
0,7,7,7,7,7,0,18,18,18,18,0,7,10,7,10,7,10,7,10,7,0,18,18,18,18,0,7,7,7,7,7,0,
0,7,7,7,7,7,0,18,18,18,0,7,10,7,10,7,10,7,10,7,10,57,0,18,18,18,0,7,7,7,7,7,0,
0,7,7,7,7,7,0,18,18,0,7,10,7,10,7,10,7,10,7,10,7,10,7,0,18,18,0,7,7,7,7,7,0,
0,7,7,7,7,7,0,18,0,7,10,7,10,7,10,7,10,7,10,7,10,7,10,7,0,18,0,7,7,7,7,7,0,
0,7,7,7,7,7,0,18,0,7,7,7,7,7,7,7,7,7,7,7,7,7,7,7,0,18,0,7,7,7,7,7,0,
0,7,7,7,7,7,0,18,18,18,18,18,18,18,18,18,18,18,18,18,18,18,18,18,18,18,0,7,7,7,7,7,0,
0,7,7,7,7,7,0,18,15,15,15,15,15,15,15,15,15,15,15,15,15,15,15,15,15,18,0,7,7,7,7,7,0,
0,7,7,7,7,7,0,18,10,18,10,18,10,18,10,18,10,18,10,18,10,18,10,18,10,18,0,7,7,7,7,7,0,
0,7,7,7,7,7,0,15,0,15,0,15,0,15,0,15,0,7,0,15,0,15,0,15,0,15,0,7,7,7,7,7,0,
0,7,7,7,7,7,0,7,0,7,0,7,0,7,0,7,0,7,0,7,0,7,0,7,0,7,0,7,7,7,7,7,0,
0,7,7,7,7,7,0,7,0,7,0,7,0,7,0,7,0,7,0,7,0,7,0,7,0,7,0,7,7,7,7,7,0,
0,0,0,0,0,0,0,7,7,7,7,7,7,7,7,7,7,7,7,7,7,7,7,7,7,7,0,0,0,0,0,0,0,
0,57,18,18,18,18,0,7,7,7,7,7,7,7,7,7,7,18,7,7,7,7,7,7,7,7,0,18,18,18,18,57,0,
0,57,18,18,18,18,0,7,7,7,7,7,7,7,7,7,7,7,7,7,7,7,7,7,7,7,0,18,18,18,18,57,0,
0,57,18,18,18,18,0,7,7,7,7,7,7,7,7,7,7,7,7,7,7,7,7,7,7,7,0,18,18,18,18,57,0,
0,57,18,18,18,18,0,7,7,7,7,7,7,7,7,7,7,7,7,7,7,7,7,7,7,7,0,18,18,18,18,57,0,
0,57,18,18,18,18,0,7,7,7,7,7,7,7,7,7,7,0,7,7,7,7,7,7,7,7,0,18,18,18,18,57,0,
0,57,18,18,18,18,0,7,7,7,7,7,7,0,0,0,0,0,0,0,0,0,7,7,7,7,0,18,18,18,18,57,0,
0,57,18,18,18,18,0,7,7,7,7,7,7,0,7,7,10,10,10,7,7,0,7,7,7,7,0,18,18,18,18,57,0,
0,57,18,18,18,18,0,7,7,7,7,7,7,0,9,7,7,7,7,7,7,7,7,7,7,7,0,18,18,18,18,57,0,
0,57,18,18,18,18,0,7,7,7,7,7,7,0,7,7,15,15,15,7,7,0,7,7,7,7,0,18,18,18,18,57,0,
0,57,18,18,18,18,0,7,7,7,7,7,7,0,7,7,18,18,18,7,7,0,7,7,7,7,0,18,18,18,18,57,0,
0,0,0,0,0,0,0,0,0,0,0,0,0,0,0,0,0,0,0,0,0,0,0,0,0,0,0,0,0,0,0,0,0,