11
137
0,0,0,0,0,0,0,0,0,0,0,
0,10,0,18,18,18,18,18,18,18,0,
0,10,0,18,10,18,18,18,10,18,0,
0,10,0,18,18,10,18,10,18,18,0,
0,10,0,10,18,18,10,18,18,10,0,
0,10,0,18,18,18,18,18,18,18,0,
0,10,0,18,18,10,18,10,18,18,0,
0,10,0,10,18,18,10,18,18,10,0,
0,10,0,18,10,18,18,18,10,18,0,
0,10,0,18,18,18,18,18,18,18,0,
0,10,0,10,18,18,10,18,18,10,0,
0,10,0,18,10,18,18,18,10,18,0,
0,10,0,18,18,10,18,10,18,18,0,
0,10,0,18,18,18,18,18,18,18,0,
0,10,0,18,18,18,18,18,18,18,0,
0,10,0,18,18,18,18,18,18,18,0,
0,10,0,18,18,18,18,18,18,18,0,
0,10,0,10,10,10,18,10,10,10,0,
0,10,0,18,18,18,18,18,18,18,0,
0,10,0,18,18,18,18,18,18,18,0,
0,10,0,18,18,18,18,18,18,18,0,
0,10,0,18,18,18,18,18,18,18,0,
0,10,0,18,10,10,10,10,10,18,0,
0,10,0,18,18,18,18,18,18,18,0,
0,10,0,18,18,18,18,18,18,18,0,
0,10,0,18,18,18,18,18,18,18,0,
0,10,0,18,18,18,18,18,18,18,0,
0,10,0,10,10,10,18,10,10,10,0,
0,10,0,18,18,18,18,18,18,18,0,
0,10,0,18,18,18,18,18,18,18,0,
0,10,0,18,18,18,18,18,18,18,0,
0,10,0,18,18,18,18,18,18,18,0,
0,10,0,10,18,10,18,10,18,10,0,
0,10,0,18,18,18,18,18,18,18,0,
0,10,0,18,10,18,10,18,10,18,0,
0,10,0,18,18,18,18,18,18,18,0,
0,10,0,10,18,10,18,10,18,10,0,
0,10,0,18,18,18,18,18,18,18,0,
0,10,0,18,10,18,10,18,10,18,0,
0,10,0,18,18,18,18,18,18,18,0,
0,10,0,10,18,10,18,10,18,10,0,
0,10,0,18,18,18,18,18,18,18,0,
0,10,0,18,10,18,10,18,10,18,0,
0,10,0,18,18,18,18,18,18,18,0,
0,10,0,10,18,10,18,10,18,10,0,
0,10,0,18,18,18,18,18,18,18,0,
0,10,0,18,18,18,18,18,18,18,0,
0,10,0,18,18,18,18,18,18,18,0,
0,10,0,18,18,18,18,18,18,18,0,
0,10,0,18,10,10,10,10,10,10,0,
0,10,0,18,18,18,18,18,18,18,0,
0,10,0,18,18,18,18,18,18,18,0,
0,10,0,18,18,18,18,18,18,18,0,
0,10,0,18,18,18,18,18,18,18,0,
0,10,0,18,18,18,18,18,18,18,0,
0,10,0,18,18,18,18,18,18,18,0,
0,10,0,10,10,10,10,10,10,18,0,
0,10,0,18,18,18,18,18,18,18,0,
0,10,0,18,18,18,18,18,18,18,0,
0,10,0,18,18,18,18,18,18,18,0,
0,10,0,18,18,18,18,18,18,18,0,
0,10,0,18,18,10,10,10,10,10,0,
0,10,0,18,18,18,18,18,18,18,0,
0,10,0,18,18,18,18,18,18,18,0,
0,10,0,18,18,18,18,18,18,18,0,
0,10,0,18,18,18,18,18,18,18,0,
0,10,0,10,10,10,10,10,18,18,0,
0,10,0,18,18,18,18,18,18,18,0,
0,10,0,18,18,18,18,18,18,18,0,
0,10,0,18,18,18,18,10,10,10,0,
0,10,0,18,18,18,18,18,18,18,0,
0,10,0,18,18,18,18,18,18,18,0,
0,10,0,18,18,18,18,18,18,18,0,
0,10,0,18,18,18,18,18,18,18,0,
0,0,0,15,15,15,15,15,15,15,0,
0,7,0,18,18,18,18,18,18,18,0,
0,7,0,18,18,18,18,18,18,18,0,
0,7,0,18,18,18,18,18,18,18,0,
0,7,0,18,18,18,18,18,18,18,0,
0,7,0,10,10,10,10,10,10,18,0,
0,7,0,18,18,18,18,18,18,18,0,
0,7,0,18,18,18,18,18,18,18,0,
0,7,0,18,18,18,18,18,18,18,0,
0,7,0,18,18,18,18,18,18,18,0,
0,7,0,18,18,18,18,18,18,18,0,
0,7,0,18,10,10,10,10,10,18,0,
0,7,0,18,18,18,18,18,18,18,0,
0,7,0,18,18,18,18,18,18,18,0,
0,7,0,18,18,18,18,18,18,18,0,
0,7,0,10,10,10,10,10,18,10,0,
0,7,0,18,18,18,18,18,18,18,0,
0,7,0,18,18,18,18,18,18,18,0,
0,7,0,18,18,18,18,18,18,18,0,
0,7,0,18,18,18,18,18,18,18,0,
0,7,0,18,18,18,18,18,18,18,0,
0,7,0,18,10,10,10,10,10,10,0,
0,7,0,18,18,18,18,18,18,18,0,
0,7,0,18,18,18,18,18,18,18,0,
0,7,0,18,18,18,18,18,18,18,0,
0,7,0,18,18,18,18,18,18,18,0,
0,7,0,18,18,18,18,18,18,18,0,
0,7,0,18,18,18,18,18,18,18,0,
0,7,0,18,18,18,18,18,18,18,0,
0,7,0,10,10,10,10,10,10,18,0,
0,7,0,18,18,18,18,18,18,18,0,
0,7,0,18,18,18,18,18,18,18,0,
0,7,0,18,18,18,18,18,18,18,0,
0,7,0,18,18,18,18,18,18,18,0,
0,7,0,18,18,18,18,18,18,18,0,
0,7,0,10,10,18,18,18,10,10,0,
0,7,0,18,18,18,18,18,18,18,0,
0,7,0,18,18,18,18,18,18,18,0,
0,7,0,18,18,18,18,18,18,18,0,
0,7,0,10,18,10,18,10,18,10,0,
0,7,0,18,18,18,18,18,18,18,0,
0,7,0,18,18,18,18,18,18,18,0,
0,7,0,18,18,18,18,18,18,18,0,
0,7,0,18,10,18,10,18,10,18,0,
0,7,0,18,18,18,18,18,18,18,0,
0,7,0,18,18,18,18,18,18,18,0,
0,7,0,18,18,18,18,18,18,18,0,
0,7,0,10,18,10,18,10,18,10,0,
0,7,0,18,18,18,18,18,18,18,0,
0,7,0,18,18,18,18,18,18,18,0,
0,7,0,18,18,18,18,18,18,18,0,
0,7,0,18,10,18,10,18,10,18,0,
0,7,0,18,18,18,18,18,18,18,0,
0,7,0,18,18,18,18,18,18,18,0,
0,7,0,18,18,18,18,18,18,18,0,
0,7,0,18,18,18,18,18,18,18,0,
0,7,0,10,10,10,18,10,10,10,0,
0,7,0,18,18,18,18,18,18,18,0,
0,7,0,18,18,18,18,18,18,18,0,
0,7,0,18,18,18,18,18,18,18,0,
0,7,0,18,18,18,18,18,18,18,0,
0,3,0,18,18,18,9,18,18,18,0,
0,0,0,0,0,0,0,0,0,0,0,