40
30
0,0,0,0,0,0,0,0,0,0,0,0,0,0,0,0,0,0,0,0,0,0,0,0,0,0,0,0,0,0,0,0,0,0,0,0,0,0,0,0,
0,11,11,7,7,7,7,7,11,7,10,7,7,11,7,7,7,7,7,10,11,0,0,0,0,0,0,11,11,10,7,7,11,7,11,7,7,57,18,0,
0,11,11,10,7,7,10,7,10,7,10,7,7,10,7,7,11,7,7,7,0,0,11,11,11,11,0,0,0,0,7,7,10,10,11,7,7,10,10,0,
0,10,7,10,10,18,10,10,10,7,11,7,7,10,18,18,7,7,11,11,0,11,10,10,10,10,11,11,11,0,10,11,11,10,10,7,7,0,10,0,
0,0,0,0,0,11,10,7,7,7,0,0,7,10,7,7,7,7,11,11,7,10,7,7,7,10,10,10,10,0,0,10,7,10,7,11,7,18,10,0,
0,7,11,7,0,0,0,0,0,0,11,11,0,0,0,0,0,11,11,7,0,7,7,7,18,18,7,7,7,7,0,0,10,7,11,7,7,18,10,0,
0,11,10,10,11,7,7,7,7,18,7,7,18,10,10,7,0,7,7,7,7,7,10,7,7,18,18,7,0,10,10,0,0,7,7,7,7,10,0,0,
0,11,11,11,11,7,7,10,7,18,10,10,18,7,7,10,0,7,7,10,10,7,0,11,7,7,10,7,7,7,7,7,0,18,7,7,7,10,18,0,
0,10,11,10,0,11,7,0,7,7,11,7,10,10,10,10,7,11,7,0,7,7,7,7,7,7,7,10,10,7,7,7,7,7,7,7,7,10,18,0,
0,7,0,7,7,10,7,10,7,7,10,11,7,10,10,7,7,7,7,7,18,7,7,7,18,7,7,0,7,7,11,7,7,7,0,7,7,0,7,0,
0,7,7,7,7,10,7,7,7,7,10,7,10,0,18,7,10,7,7,7,18,18,7,18,18,7,7,7,10,10,7,7,0,7,7,7,7,7,18,0,
0,7,7,7,7,0,18,18,18,7,7,0,0,0,18,18,10,7,7,7,7,18,18,18,7,7,11,7,10,7,7,0,0,7,7,7,7,7,18,0,
0,7,7,7,7,7,18,0,18,7,7,0,11,10,7,18,0,7,11,7,7,18,57,18,7,7,7,10,0,7,7,0,11,10,7,7,10,7,18,0,
0,0,0,0,0,0,0,0,0,0,0,11,10,7,7,7,10,7,7,7,18,18,7,18,18,7,7,10,7,7,0,0,11,10,7,7,11,10,18,0,
0,7,11,7,10,7,10,7,10,10,0,0,0,18,7,7,7,7,10,7,18,7,7,7,18,7,7,11,7,7,0,7,10,7,7,7,11,7,18,0,
0,10,10,7,11,7,7,7,0,7,7,11,0,10,18,10,10,7,0,7,7,7,7,7,7,11,7,7,7,0,0,7,7,7,10,7,10,7,18,0,
0,7,10,10,7,10,7,58,18,18,18,7,0,0,18,7,10,7,10,7,7,10,10,7,7,7,0,0,0,0,7,7,7,7,7,10,11,7,18,0,
0,10,11,0,7,7,7,18,18,18,18,7,11,0,10,18,7,7,11,10,7,10,0,7,11,7,0,10,10,10,7,10,7,7,7,10,7,7,18,0,
0,10,7,7,7,7,7,18,18,18,18,7,11,0,0,10,18,7,10,10,7,10,7,10,7,0,0,7,10,10,7,7,7,7,10,10,7,7,18,0,
0,7,7,10,7,7,10,7,18,58,18,7,7,11,0,0,18,7,0,0,7,11,7,10,7,0,7,7,10,7,7,7,7,10,10,0,7,7,7,0,
0,7,7,7,7,7,7,7,7,18,18,18,7,11,11,0,18,7,7,7,10,18,18,18,18,0,7,7,7,7,7,7,7,10,0,7,11,11,7,0,
0,0,7,7,7,0,0,0,0,0,0,0,0,0,0,0,0,0,0,0,0,0,0,0,0,11,7,7,7,10,7,7,7,0,7,10,10,11,7,0,
0,7,7,7,7,7,7,7,10,7,10,7,7,10,7,7,7,18,18,18,7,7,10,7,7,11,7,7,7,7,7,3,7,7,7,7,10,10,7,0,
0,7,7,7,7,10,7,10,7,7,7,7,7,10,10,10,7,18,10,18,10,7,7,7,7,0,7,7,7,0,7,7,7,7,7,7,7,7,7,0,
0,7,10,7,10,7,7,7,7,7,18,10,7,7,0,7,7,7,10,11,11,11,7,10,10,0,7,18,18,18,18,7,7,7,7,0,7,7,7,0,
0,7,18,7,18,7,7,10,7,18,18,11,10,7,7,7,10,7,10,11,7,7,10,7,10,0,7,18,10,10,10,7,10,7,7,10,7,7,7,0,
0,7,18,7,18,7,7,7,7,7,18,18,10,10,7,7,10,7,7,7,7,7,7,7,7,0,7,7,10,10,0,7,7,10,7,7,18,18,11,0,
0,7,18,9,18,7,7,7,7,7,7,7,0,7,7,7,7,7,7,10,7,10,7,10,7,0,7,7,10,0,11,7,7,7,10,0,18,57,11,0,
0,7,18,7,18,7,7,7,10,7,7,7,7,7,10,7,10,7,10,10,7,7,7,10,7,0,7,7,11,11,11,7,7,7,7,7,11,11,11,0,
0,0,0,0,0,0,0,0,0,0,0,0,0,0,0,0,0,0,0,0,0,0,0,0,0,0,0,0,0,0,0,0,0,0,0,0,0,0,0,0,