21
30
0,0,0,0,0,0,0,0,0,0,0,0,0,0,0,0,0,0,0,0,0,
0,18,18,18,18,18,18,18,18,18,18,10,10,10,7,7,7,7,7,7,0,
0,18,18,18,0,18,18,18,18,18,18,10,10,10,7,7,7,10,10,7,0,
0,18,57,18,18,18,18,0,18,18,10,10,10,10,7,7,10,10,7,7,0,
0,18,18,18,18,18,18,18,18,7,10,7,7,7,7,7,10,10,7,7,0,
0,18,18,18,18,0,18,18,7,7,7,7,7,0,7,7,10,7,0,0,0,
0,18,18,18,18,18,18,18,18,18,7,7,0,18,18,57,7,7,0,7,0,
0,18,18,18,18,0,18,18,0,18,18,0,7,18,0,18,7,7,0,7,0,
0,18,7,7,7,7,18,18,18,18,18,0,10,7,18,18,7,0,0,7,0,
0,7,7,10,7,7,7,18,18,18,18,7,10,7,18,0,0,0,7,7,0,
0,7,7,10,7,7,7,7,7,7,0,10,10,7,18,18,18,7,7,7,0,
0,0,10,10,7,7,7,7,7,0,0,0,7,7,0,18,18,18,7,7,0,
0,0,7,7,7,7,7,7,7,0,7,0,0,7,7,18,18,18,7,7,0,
0,0,0,7,7,7,7,7,0,0,7,7,0,7,7,7,7,18,18,7,0,
0,7,0,7,7,7,7,7,7,7,7,7,0,7,7,7,7,7,18,7,0,
0,7,7,0,7,7,7,7,7,7,9,7,7,7,7,7,7,7,7,7,0,
0,7,7,7,7,7,7,7,7,7,7,7,7,7,7,7,7,7,7,7,0,
0,0,0,0,7,0,0,0,7,0,0,0,7,0,0,0,7,0,0,0,0,
0,18,0,7,58,7,0,7,58,7,0,7,58,7,0,7,58,7,0,18,0,
0,18,0,7,18,7,0,7,18,7,0,7,18,7,0,7,18,7,0,18,0,
0,18,0,7,18,7,0,7,18,7,0,7,18,7,0,7,18,7,0,18,0,
0,18,0,7,18,7,0,7,18,7,0,7,18,7,0,7,18,7,0,18,0,
0,18,0,7,15,7,0,7,15,7,0,7,15,7,0,7,15,7,0,18,0,
0,18,0,7,18,7,0,7,18,7,0,7,18,7,0,7,18,7,0,18,0,
0,18,0,7,18,7,0,7,18,7,0,7,18,7,0,7,18,7,0,18,0,
0,18,0,7,18,7,0,7,18,7,0,7,18,7,0,7,18,7,0,18,0,
0,18,0,7,7,7,0,7,7,7,0,7,7,7,0,7,7,7,0,18,0,
0,18,0,0,0,0,0,0,0,0,0,0,0,0,0,0,0,0,0,18,0,
0,18,18,18,18,18,18,18,18,18,18,18,18,18,18,18,18,18,18,18,0,
0,0,0,0,0,0,0,0,0,0,0,0,0,0,0,0,0,0,0,0,0,