19
35
15,15,15,15,15,15,15,15,15,15,15,15,15,15,15,15,15,15,15,
15,18,57,18,18,18,15,18,18,18,18,18,15,18,18,57,18,18,15,
15,18,57,18,57,18,15,18,18,18,18,18,15,18,57,18,18,57,15,
15,18,18,57,57,18,15,18,18,9,18,18,15,18,18,57,18,18,15,
15,18,18,57,18,18,15,18,18,18,18,18,15,57,18,18,18,57,15,
15,15,15,15,15,15,15,18,18,18,18,18,15,15,15,15,15,15,15,
0,7,7,7,7,7,7,7,7,7,7,7,7,7,7,7,7,7,0,
0,7,7,7,10,7,7,7,7,7,7,7,7,7,10,7,7,7,0,
0,7,7,7,10,7,7,7,7,7,7,7,7,7,10,7,7,7,0,
0,7,7,7,10,7,7,7,7,7,7,7,7,7,10,7,7,7,0,
0,7,10,7,10,7,10,7,7,7,7,7,10,7,10,7,10,7,0,
0,7,10,7,10,7,10,7,7,7,7,7,10,7,10,7,10,7,0,
0,7,10,7,10,7,7,7,7,10,7,7,7,7,10,7,10,7,0,
0,7,10,7,7,7,7,7,7,10,7,7,7,7,7,7,10,7,0,
0,7,7,7,7,7,7,7,7,10,7,7,7,7,7,7,7,7,0,
0,7,7,7,7,10,7,7,7,10,7,7,7,10,7,7,7,7,0,
0,7,7,7,7,10,7,7,7,7,7,7,7,10,7,7,7,7,0,
0,7,7,7,7,10,7,7,7,7,7,7,7,10,7,7,7,7,0,
0,7,7,7,7,10,7,7,7,7,7,7,7,10,7,7,7,7,0,
0,7,10,7,7,7,7,7,7,7,7,7,7,7,7,7,10,7,0,
0,0,7,7,7,7,7,7,7,7,7,7,7,7,7,7,7,0,0,
0,7,7,7,7,7,7,7,7,7,7,7,7,7,7,7,7,7,0,
0,7,57,18,18,18,18,18,18,7,18,18,18,18,18,18,57,7,0,
0,0,7,7,7,7,7,7,7,7,7,7,7,7,7,7,7,0,0,
0,7,7,7,7,7,7,7,7,7,7,7,7,7,7,7,7,7,0,
0,7,57,18,18,18,18,18,18,7,18,18,18,18,18,18,57,7,0,
0,7,7,7,7,7,7,7,18,18,18,7,7,7,7,7,7,7,0,
0,7,7,7,7,7,7,7,7,7,7,7,7,7,7,7,7,7,0,
0,7,57,18,18,18,18,18,18,7,18,18,18,18,18,18,57,7,0,
0,0,7,7,7,7,7,7,7,7,7,7,7,7,7,7,7,0,0,
0,7,7,7,7,7,7,7,7,7,7,7,7,7,7,7,7,7,0,
0,7,57,18,18,18,18,18,18,7,18,18,18,18,18,18,57,7,0,
0,7,7,7,7,7,7,7,18,18,18,7,7,7,7,7,7,7,0,
0,7,7,7,7,7,7,7,7,3,7,7,7,7,7,7,7,7,0,
0,0,0,0,0,0,0,0,0,0,0,0,0,0,0,0,0,0,0,