39
35
0,0,0,0,0,0,0,0,0,0,0,0,0,0,0,0,0,0,0,0,0,0,0,0,0,0,0,0,0,0,0,0,0,0,0,0,0,0,0,
0,7,7,7,7,7,7,7,7,7,7,7,7,7,7,7,7,7,7,7,7,7,7,7,7,7,7,7,7,7,7,7,7,7,7,7,7,7,0,
0,7,7,7,7,7,7,7,7,7,7,7,7,7,7,7,7,7,7,7,7,7,7,7,7,7,7,7,7,7,7,7,7,7,7,7,7,7,0,
0,7,7,7,7,7,7,7,7,7,7,7,7,7,7,7,7,7,7,7,7,7,7,7,7,7,7,7,7,7,7,7,7,7,7,7,7,7,0,
0,7,7,7,7,7,7,7,7,7,7,7,7,7,7,7,7,7,7,7,7,7,7,7,7,7,7,7,7,7,7,7,7,7,7,7,7,7,0,
0,7,7,7,7,7,7,7,7,7,7,7,7,7,7,7,7,7,7,3,7,7,7,7,7,7,7,7,7,7,7,7,7,7,7,7,7,7,0,
0,7,7,7,7,7,7,7,7,7,7,7,7,7,7,7,7,10,10,7,7,7,7,7,7,58,18,18,7,7,7,7,7,7,7,7,7,7,0,
0,7,7,7,7,7,7,7,7,7,7,10,7,7,7,10,10,7,15,7,7,10,10,7,7,11,11,11,7,7,7,7,7,7,7,7,7,7,0,
0,7,7,7,7,7,7,7,7,7,7,7,10,11,7,7,7,10,7,10,7,7,7,7,10,7,7,7,10,10,7,7,7,7,7,7,7,7,0,
0,7,7,7,7,7,7,7,0,7,7,10,7,7,7,10,7,11,7,7,7,11,10,7,7,7,10,11,7,7,7,7,7,7,7,7,7,7,0,
0,7,7,7,7,7,7,7,7,7,7,7,10,10,7,7,10,7,0,7,11,7,7,7,7,7,7,7,10,7,7,7,7,7,7,7,7,7,0,
0,7,7,7,7,7,7,7,7,10,7,0,7,7,11,0,7,7,7,7,7,10,7,10,11,10,7,10,7,7,7,7,7,7,7,7,7,7,0,
0,7,7,7,7,7,7,7,7,10,10,10,7,10,7,7,7,10,10,7,7,7,7,10,7,7,7,7,7,7,7,7,7,7,7,7,7,7,0,
0,7,7,7,7,7,7,7,7,7,10,7,11,10,10,7,7,7,10,11,10,10,7,7,7,10,7,10,7,10,7,7,7,7,7,7,7,7,0,
0,7,7,7,7,7,10,10,7,7,11,7,7,0,7,10,7,7,7,7,7,7,7,11,7,7,11,0,7,7,7,7,7,7,7,7,7,7,0,
0,7,7,7,7,7,7,7,7,7,10,7,7,10,7,11,7,7,7,7,7,0,10,7,10,7,10,7,7,7,10,7,7,7,7,7,7,7,0,
0,7,7,7,7,7,7,7,10,7,7,7,10,7,7,7,7,10,7,7,10,7,7,7,10,7,7,7,0,7,7,7,7,7,7,7,7,7,0,
0,7,7,7,7,3,7,7,7,7,7,11,7,10,7,7,10,7,7,9,7,7,10,7,7,10,7,10,7,7,10,7,7,3,7,7,7,7,0,
0,7,7,7,7,7,7,7,10,11,7,10,7,7,10,7,7,10,7,7,7,7,7,7,11,7,7,11,7,7,7,7,7,7,7,7,7,7,0,
0,7,7,7,7,7,7,7,7,7,7,0,7,11,7,10,7,7,7,7,10,7,10,7,0,7,7,7,7,7,7,7,7,7,7,7,7,7,0,
0,7,7,7,7,7,7,7,7,7,7,10,7,7,7,7,7,7,10,7,7,7,7,7,10,7,10,10,7,7,10,7,7,7,7,7,7,7,0,
0,7,7,7,7,7,7,7,10,7,10,7,10,10,7,7,11,7,10,7,7,10,7,10,7,7,10,7,11,7,10,7,7,7,7,7,7,7,0,
0,7,7,7,7,7,7,7,7,7,7,7,11,7,7,7,10,7,7,7,10,7,7,11,7,7,11,7,7,7,7,10,7,7,7,7,7,7,0,
0,7,7,7,7,7,7,7,7,10,7,7,7,7,7,10,7,11,7,7,7,10,10,7,7,10,7,10,7,7,7,7,7,7,7,7,7,7,0,
0,7,7,7,7,7,7,7,7,7,7,10,11,7,7,7,7,7,10,7,7,7,7,7,7,0,7,7,10,7,7,7,7,7,7,7,7,7,0,
0,7,7,7,7,7,7,7,0,7,7,7,7,7,7,10,7,7,7,7,10,11,7,0,7,10,10,7,7,7,7,7,7,7,7,7,7,7,0,
0,7,7,7,7,7,7,7,7,7,7,7,7,7,7,0,7,11,7,7,7,10,10,7,7,7,7,7,10,7,7,7,7,7,7,7,7,7,0,
0,7,7,7,7,7,7,7,7,7,58,18,18,7,10,7,7,7,7,7,7,10,7,7,7,11,7,7,7,7,7,7,7,7,7,7,7,7,0,
0,7,7,7,7,7,7,7,7,7,11,11,11,7,7,7,7,10,7,7,7,7,7,7,7,7,7,7,7,7,7,7,7,7,7,7,7,7,0,
0,7,7,7,7,7,7,7,7,7,7,7,7,7,7,7,7,7,7,3,7,7,7,7,7,7,7,7,7,7,7,7,7,7,7,7,7,7,0,
0,7,7,7,7,7,7,7,7,7,7,7,7,7,7,7,7,7,7,7,7,7,7,7,7,7,7,7,7,7,7,7,7,7,7,7,7,7,0,
0,7,7,7,7,7,7,7,7,7,7,7,7,7,7,7,7,7,7,7,7,7,7,7,7,7,7,7,7,7,7,7,7,7,7,7,7,7,0,
0,7,7,7,7,7,7,7,7,7,7,7,7,7,7,7,7,7,7,7,7,7,7,7,7,7,7,7,7,7,7,7,7,7,7,7,7,7,0,
0,7,7,7,7,7,7,7,7,7,7,7,7,7,7,7,7,7,7,7,7,7,7,7,7,7,7,7,7,7,7,7,7,7,7,7,7,7,0,
0,0,0,0,0,0,0,0,0,0,0,0,0,0,0,0,0,0,0,0,0,0,0,0,0,0,0,0,0,0,0,0,0,0,0,0,0,0,0,