25
40
11,10,10,11,11,10,10,10,11,10,10,10,11,10,10,11,10,11,10,10,10,11,11,10,11,
11,11,11,10,11,10,10,11,11,10,11,10,10,11,10,10,10,10,10,10,10,10,11,11,11,
11,11,10,11,11,11,11,11,10,10,10,10,11,10,10,10,10,11,11,10,11,10,11,10,11,
11,10,10,11,11,10,11,10,11,11,11,10,10,10,11,10,10,10,10,10,11,11,11,10,11,
11,10,11,11,10,10,10,11,10,10,10,10,11,11,11,11,10,10,11,10,10,11,11,11,11,
11,10,11,11,10,11,11,10,10,11,10,10,10,10,10,10,11,10,11,10,11,11,10,11,11,
11,10,11,11,11,11,11,10,11,11,11,10,10,10,10,10,10,11,10,11,11,10,10,10,11,
0,11,10,11,11,10,11,10,11,10,10,10,11,10,11,10,11,11,11,11,11,11,11,11,0,
10,0,11,11,11,10,11,10,10,10,10,10,10,10,10,10,11,10,10,11,10,11,11,0,10,
10,10,0,11,11,11,11,11,10,10,11,10,10,11,10,11,10,10,11,11,10,11,0,10,10,
11,10,11,0,11,11,11,10,11,10,11,10,10,10,10,11,10,10,11,10,11,0,11,10,10,
11,10,10,11,0,11,10,10,10,10,10,11,11,10,10,11,10,10,11,11,0,11,10,10,10,
10,10,10,10,10,0,11,10,11,10,10,10,10,10,10,11,10,10,11,0,10,10,10,10,11,
10,10,10,10,10,10,0,11,10,10,10,11,10,11,10,10,10,11,0,11,11,10,11,10,10,
10,10,10,10,11,10,10,0,11,10,11,11,11,10,10,10,11,0,10,11,10,11,11,10,11,
11,10,10,10,11,11,10,10,0,11,10,10,10,10,11,11,0,11,11,11,10,10,11,10,10,
11,10,11,10,11,10,10,11,10,0,11,11,10,11,11,0,10,11,10,10,11,11,10,10,10,
11,10,11,11,11,10,11,10,11,10,0,11,10,11,0,11,11,10,10,10,11,10,11,10,10,
10,10,11,0,0,0,0,0,0,0,0,0,7,0,0,0,0,0,0,0,0,0,10,10,11,
10,11,11,0,18,18,18,18,18,18,18,18,18,18,18,18,18,18,18,18,18,0,10,10,11,
10,11,10,0,18,0,18,18,18,18,18,18,18,18,18,18,18,18,18,18,18,0,11,10,11,
10,10,10,0,18,18,18,18,18,18,18,18,18,18,18,18,18,18,18,18,18,0,11,10,11,
11,11,10,0,18,18,18,18,18,18,18,18,18,18,18,18,18,18,18,18,18,0,10,10,11,
11,10,11,0,18,18,18,18,18,18,18,18,9,18,18,18,18,18,18,18,18,0,10,10,10,
11,10,11,0,18,18,18,18,18,18,18,18,18,18,18,18,18,18,18,18,18,0,10,10,11,
11,11,11,0,18,18,18,18,18,18,18,18,18,18,18,18,18,18,18,18,18,0,10,10,10,
11,10,11,0,18,18,18,18,18,18,18,18,18,18,18,18,18,18,18,18,18,0,11,10,10,
10,11,11,0,18,18,18,18,18,18,18,18,18,18,18,18,18,18,18,18,18,0,10,10,10,
11,11,10,0,18,18,18,18,18,18,18,18,18,18,18,18,18,18,18,18,18,0,10,10,10,
11,10,10,0,18,18,18,18,18,18,18,18,18,18,18,18,18,18,18,18,18,0,11,10,10,
10,11,10,0,18,18,18,18,18,18,18,18,18,18,18,18,18,18,18,18,18,0,11,10,11,
11,11,10,0,18,18,18,18,18,18,18,18,18,18,18,18,18,18,18,18,18,0,11,10,11,
11,11,10,0,18,18,18,18,18,18,18,18,18,18,18,18,18,18,18,18,18,0,10,10,10,
10,10,10,0,18,18,18,18,18,18,18,18,18,18,18,18,18,18,18,18,18,0,10,10,10,
10,10,11,0,18,18,18,18,18,18,18,18,18,18,18,18,18,18,18,18,18,0,10,10,10,
10,10,11,0,18,18,18,18,18,18,18,18,18,18,18,18,18,18,18,18,18,0,10,10,11,
11,10,10,0,0,0,0,0,0,0,0,0,0,0,0,0,0,0,0,0,0,0,11,10,10,
11,10,10,11,10,11,10,11,11,10,10,10,11,11,11,11,10,10,10,10,11,10,11,10,10,
10,10,11,10,11,10,10,11,11,10,11,10,11,10,11,11,10,11,10,10,10,10,10,10,11,
10,10,11,11,10,11,10,10,10,10,11,11,10,10,10,10,10,11,11,11,10,11,11,10,10,