23
23
0,0,0,0,0,0,0,0,0,0,0,0,0,0,0,0,0,0,0,0,0,0,0,
0,7,7,10,10,7,7,0,0,11,11,11,11,11,0,0,7,7,10,7,7,7,0,
0,7,7,7,7,7,7,0,0,7,7,7,7,7,0,0,7,7,7,7,7,7,0,
0,7,7,57,18,7,7,0,0,58,18,18,18,58,0,0,7,7,18,57,7,7,0,
0,7,7,18,18,7,7,0,0,18,18,18,18,18,0,0,7,7,18,18,7,7,0,
0,7,7,7,7,7,7,0,0,18,18,18,18,18,0,0,7,7,7,7,7,7,0,
0,7,7,7,7,7,7,7,7,7,7,7,7,7,7,7,7,7,7,7,7,7,0,
0,0,0,0,0,0,7,7,7,7,7,11,7,7,7,7,7,0,0,0,0,0,0,
0,0,0,0,0,0,7,7,11,7,7,7,7,7,11,7,7,0,0,0,0,0,0,
0,11,7,18,18,58,7,7,7,7,7,0,7,7,7,7,7,58,18,18,7,11,0,
0,11,7,18,18,18,7,7,7,7,10,10,10,7,7,7,7,18,18,18,7,11,0,
0,11,7,18,18,18,7,11,18,18,10,9,10,18,18,11,7,18,18,18,7,11,0,
0,11,7,18,18,18,7,7,7,7,10,10,10,7,7,7,7,18,18,18,7,11,0,
0,11,7,18,18,58,7,7,7,7,7,7,7,7,7,7,7,58,18,18,7,11,0,
0,0,0,0,0,0,7,7,11,7,7,7,7,7,11,7,7,0,0,0,0,0,0,
0,0,0,0,0,0,7,7,7,7,7,11,7,7,7,7,7,0,0,0,0,0,0,
0,7,7,7,10,7,7,7,7,7,7,7,7,7,7,7,7,7,10,10,7,7,0,
0,7,7,7,7,7,7,0,0,58,18,18,18,58,0,0,7,7,7,7,7,7,0,
0,7,7,18,18,7,7,0,0,18,18,18,18,18,0,0,7,7,18,18,7,7,0,
0,7,7,57,18,7,7,0,0,18,18,18,18,18,0,0,7,7,18,57,7,7,0,
0,7,7,7,7,7,7,0,0,7,7,7,7,7,0,0,7,7,7,7,7,7,0,
0,7,7,7,7,7,7,0,0,11,11,11,11,11,0,0,7,7,7,7,7,7,0,
0,0,0,0,0,0,0,0,0,0,0,0,0,0,0,0,0,0,0,0,0,0,0,